border_size=1
usage=map

Wo          , Wo          , Wo          , Wo          , Wo          , Wo          , Wo          , Wo          , Wo          , Wo          , Wo          , Wo          , Wo          , Wo          , Wo          , Wo          , Wo          , Wo          , Wo          , Wo          , Wo          , Wo          , Wo          , Wo          , Wo          , Wo          , Wo          
Wo          , Wo          , Wo          , Wo          , Wo          , Wo          , Wo          , Wo          , Wo          , Wo          , Wo          , Wo          , Wo          , Wo          , Gs^Vh       , Wo          , Wo          , Wo          , Wo          , Wo          , Wo          , Wo          , Wo          , Wo          , Wo          , Wo          , Wo          
Wo          , Wo          , Wo          , Wo          , Wo          , Wo          , Wo          , Gs^Vh       , Rrc         , Gg          , Gg          , Wo          , Rrc         , Rrc         , Rrc         , Rrc         , Rrc         , Rrc         , Rrc         , Wo          , Gs^Vh       , Wo          , Wo          , Wo          , Wo          , Wo          , Wo          
Wo          , Wo          , Wo          , Wo          , Gg          , Wo          , Wo          , Gg          , Hh          , Rrc         , Rrc         , Wo^Bw/      , Wo          , Gg          , Gg          , Rrc         , Gs^Fds      , Gs^Fds      , Gs^Fds      , Rrc         , Rrc         , Rrc         , Rrc         , Wo          , Wo          , Wo          , Wo          
Wo          , Wo          , Wo          , Gs^Vh       , Rrc         , Wo          , Rrc         , Gg          , Rrc         , Hh          , Rrc         , Gg          , Wo          , Gg          , Gg          , Rrc         , Rrc         , Gs^Fds      , Gs^Fds      , Gg          , Gs^Fds      , Gg          , Gg          , Rrc         , Wo          , Wo          , Wo          
Wo          , Wo          , Wo          , Hh          , Rrc         , Rrc         , Gs^Fds      , Rrc         , Gs^Fds      , Rrc         , Gg          , Rrc         , Gs^Vh       , Wo          , Wo          , Gg          , Rrc         , Gg          , Gs^Fds      , Gs^Fds      , Gs^Fds      , Gs^Fds      , Gs^Fds      , Rrc         , Wo          , Wo          , Wo          
Wo          , Wo          , Wo          , Hh          , Rrc         , Gs^Fds      , Gs^Fds      , Gs^Fds      , Gs^Fds      , Gs^Fds      , Gg          , Gg          , Gg          , Rrc         , Wo          , Gg          , Rrc         , Gg          , Gg          , Gs^Fds      , Gs^Fds      , Gs^Fds      , Rrc         , Rrc         , Wo          , Wo          , Wo          
Wo          , Wo          , Wo          , Hh          , Rrc         , Gs^Fds      , Gs^Fds      , Gs^Fds      , Gs^Fds      , Gs^Fds      , Gg          , Gg          , Rrc         , Rrc         , Rrc         , Wo^Bw/      , Wo          , Gg          , Gg          , Gg          , Gg          , Rrc         , Gs^Vh       , Rrc         , Wo          , Wo          , Wo          
Wo          , Wo          , Wo          , Gg          , Gg          , Rrc         , Rrc         , Rrc         , Rrc         , Gs^Fds      , Rrc         , Rrc         , Hh          , Hh          , Gg          , Rrc         , Wo          , Wo          , Wo          , Gg          , Rrc         , Rrc         , Gs^Fds      , Wo          , Wo          , Wo          , Wo          
Wo          , Wo          , Wo          , Gg          , Wo          , Wo          , Wo          , Gs^Vh       , Rrc         , Rrc         , Gg          , Rrc         , Gs^Vh       , Hh          , Gg          , Rrc         , Wo          , Wo          , Wo          , Rrc         , Gg          , Gg          , Gs^Fds      , Gg          , Wo          , Wo          , Wo          
Wo          , Wo          , Wo          , Wo          , Wo          , Wo          , Gg          , Gg          , Rrc         , Gg          , Gg          , Gg          , Mm          , Hh          , Hh          , Rrc         , Rrc         , Rrc         , Gs^Vh       , Rrc         , Gg          , Gs^Fds      , Gs^Fds      , Gs^Fds      , Wo          , Wo          , Wo          
Wo          , Wo          , Wo          , Wo          , Gg          , Gg          , Gg          , Gg          , Rrc         , Gg          , Gs^Fds      , Mm          , Gs^Fds      , Mm          , Mm          , Gg          , Gg          , Rrc         , Rrc         , Gg          , Gg          , Gs^Fds      , Gg          , Gs^Fds      , Wo          , Wo          , Wo          
Wo          , Wo          , Wo          , Gg          , Gg          , Gg          , Hh          , Hh          , Rrc         , Gg          , Gs^Fds      , Gs^Fds      , Gs^Fds      , Gs^Fds      , Gs^Fds      , Mm          , Gg          , Gg          , Rrc         , Gg          , Mm          , Gg          , Mm          , Gg          , Wo          , Wo          , Wo          
Wo          , Wo          , Wo          , Gg          , Rrc         , Rrc         , Rrc         , Rrc         , Gg          , Gs^Vh       , Rrc         , Gs^Fds      , Gs^Fds      , Gs^Fds      , Gs^Fds      , Gs^Fds      , Gg          , Gg          , Rrc         , Gg          , Mm          , Mm          , Mm          , Mm          , Wo          , Wo          , Wo          
Wo          , Wo          , Wo          , Gs^Vh       , Mm          , Mm          , Mm          , Mm          , Mm          , Gg          , Rrc         , Rrc         , Rrc         , Gs^Fds      , Rrc         , Gg          , Gg          , Rrc         , Gg          , Gg          , Gg          , Mm          , Mm          , Mm          , Wo          , Wo          , Wo          
Wo          , Wo          , Wo          , Mm          , Mm          , Mm          , Rrc         , Mm          , Rrc         , Rrc         , Gg          , Gg          , Gg          , Rrc         , Gg          , Rrc         , Rrc         , Gs^Vh       , Hh          , Hh          , Hh          , Gg          , Gg          , Mm          , Wo          , Wo          , Wo          
Wo          , Wo          , Wo          , Mm          , Mm          , Rrc         , Hh          , Rrc         , Hh          , Gg          , Gg          , Gg          , Wo          , Wo          , Wo          , Gg          , Wo          , Rrc         , Rrc         , Gg          , Gg          , Gg          , Wo          , Wo          , Wo          , Wo          , Wo          
Wo          , Wo          , Wo          , Wo          , Gs^Vh       , Rrc         , Rrc         , Hh          , Gg          , Gg          , Gg          , Wo          , Wo          , Wo          , Wo          , Wo          , Dd          , Wo          , Wo^Bw/      , Rrc         , Rrc         , Gg          , Gg          , Wo          , Wo          , Wo          , Wo          
Wo          , Wo          , Wo          , Wo          , Gg          , Rrc         , Gs^Fds      , Rrc         , Rrc         , Gg          , Gg          , Gg          , Mm          , Wo          , Dd          , Dd          , Rrc         , Rrc         , Dd          , Wo          , Wo          , Rrc         , Rrc         , Gs^Vh       , Wo          , Wo          , Wo          
Wo          , Wo          , Wo          , Hh          , Gg          , Gg          , Gs^Fds      , Gs^Fds      , Gs^Fds      , Rrc         , Rrc         , Rrc         , Rrc         , Gs^Vh       , Rrc         , Rrc         , Dd          , Dd          , Dd          , Dd          , Wo          , Gg          , Rrc         , Gg          , Wo          , Wo          , Wo          
Wo          , Wo          , Wo          , Hh          , Wo          , Gg          , Mm          , Gs^Fds      , Mm          , Mm          , Dd          , Dd          , Rrc         , Rrc         , Rrc         , Dd          , Dd          , Dd          , Dd          , Dd          , Rrc         , Wo^Bw/      , Wo          , Gg          , Wo          , Wo          , Wo          
Wo          , Wo          , Wo          , Wo          , Wo          , Gg          , Mm          , Mm          , Dd          , Dd          , Dd          , Dd          , Rrc         , Dd          , Dd          , Rrc         , Rrc         , Gs^Vh       , Rrc         , Rrc         , Dd          , Wo          , Wo          , Wo          , Wo          , Wo          , Wo          
Wo          , Wo          , Wo          , Wo          , Wo          , Wo          , Dd          , Dd          , Dd          , Dd          , Rrc         , Rrc         , Dd          , Dd          , Dd          , Dd          , Dd          , Rrc         , Rrc         , Dd          , Dd          , Dd          , Dd          , Wo          , Wo          , Wo          , Wo          
Wo          , Wo          , Wo          , Wo          , Wo          , Wo          , Wo          , Dd          , Dd          , Rrc         , Gs^Vh       , Wo          , Wo          , Dd          , Dd          , Dd          , Dd          , Dd          , Dd          , Rrc         , Rrc         , Dd          , Dd          , Wo          , Wo          , Wo          , Wo          
Wo          , Wo          , Wo          , Wo          , Wo          , Wo          , Wo          , Dd          , Wo          , Dd          , Wo          , Wo          , Wo          , Wo          , Wo          , Dd          , Wo          , Dd          , Wo          , Dd          , Wo          , Gs^Vh       , Wo          , Wo          , Wo          , Wo          , Wo          
Wo          , Wo          , Wo          , Wo          , Wo          , Wo          , Wo          , Wo          , Wo          , Wo          , Wo          , Wo          , Wo          , Wo          , Wo          , Wo          , Wo          , Wo          , Wo          , Wo          , Wo          , Wo          , Wot         , Wo          , Wo          , Wo          , Wo          
Wo          , Wo          , Wo          , Wo          , Wo          , Wo          , Wo          , Wo          , Wo          , Wo          , Wo          , Wo          , Wo          , Wo          , Wo          , Wo          , Wo          , Wo          , Wo          , Wo          , Wo          , Wo          , Wo          , Wo          , Wo          , Wo          , Wo          
