border_size=1
usage=map

Wo          , Wo          , Wo          , Wo          , Wo          , Wo          , Wo          , Wo          , Wo          , Wo          , Wo          , Wo          , Wo          , Wo          , Wo          , Wo          , Wo          , Wo          , Wo          , Wo          , Wo          , Wo          , Wo          , Wo          , Wo          , Wo          , Wo          
Wo          , Wo          , Wo          , Wo          , Wo          , Wo          , Wo          , Wo          , Wo          , Wo          , Gg          , Wo          , Gg          , Wo          , Gg          , Wo          , Wo          , Wo          , Wo          , Wo          , Wo          , Wo          , Wo          , Wo          , Wo          , Wo          , Wo          
Wo          , Wo          , Wo          , Wo          , Wo          , Wo          , Wo          , Gg          , Gg          , Gg          , Gg          , Wo^Bw\      , Gg          , Gg          , Gg          , Gg          , Gg          , Gg          , Gg          , Gg          , Gg          , Wo          , Wo          , Wo          , Wo          , Wo          , Wo          
Wo          , Wo          , Wo          , Wo          , Gg          , Wo          , Wo          , Gg          , Hh          , Gg          , Gg          , Wo          , Wo          , Gg          , Gg          , Gg          , Gs^Fds      , Gs^Fds      , Gs^Fds      , Gs^Fds      , Gs^Fds      , Gg          , Gg          , Wo          , Wo          , Wo          , Wo          
Wo          , Wo          , Wo          , Gg          , Gg          , Wo          , Gg          , Gg          , Gg          , Hh          , Gg          , Gg          , Wo          , Gg          , Gg          , Gg          , Gg          , Gs^Fds      , Gs^Fds      , Gs^Fds      , Gs^Fds      , Gg          , Gg          , Gg          , Wo          , Wo          , Wo          
Wo          , Wo          , Gg          , Hh          , Gg          , Gg          , Gs^Fds      , Gg          , Gs^Fds      , Gg          , Gg          , Gg          , Gg          , Wo          , Wo          , Gg          , Gg          , Gg          , Gs^Fds      , Gs^Fds      , Gs^Fds      , Gs^Fds      , Gs^Fds      , Gg          , Wo          , Wo          , Wo          
Wo          , Wo          , Gg          , Hh          , Gg          , Gs^Fds      , Gs^Fds      , Gs^Fds      , Gs^Fds      , Gs^Fds      , Gg          , Gg          , Gg          , Gg          , Wo          , Gg          , Gg          , Gg          , Gg          , Gs^Fds      , Gs^Fds      , Gs^Fds      , Gg          , Gg          , Gg          , Wo          , Wo          
Wo          , Wo          , Gg          , Hh          , Gg          , Gs^Fds      , Gs^Fds      , Gs^Fds      , Gs^Fds      , Gs^Fds      , Gg          , Gg          , Gg          , Gg          , Gg          , Wo^Bw\      , Wo          , Gg          , Gg          , Gg          , Gg          , Gg          , Gg          , Gg          , Gg          , Wo          , Wo          
Wo          , Wo          , Gg          , Gg          , Gg          , Gg          , Gg          , Gs^Fds      , Gg          , Gs^Fds      , Gg          , Gg          , Hh          , Hh          , Gg          , Gg          , Wo          , Wo          , Wo          , Gg          , Gg          , Gg          , Gs^Fds      , Gg          , Gg          , Wo          , Wo          
Wo          , Wo          , Wo          , Gg          , Wo          , Wo          , Wo          , Gg          , Gg          , Gg          , Gg          , Gg          , Gg          , Hh          , Gg          , Gg          , Wo          , Wo          , Wo          , Gg          , Gg          , Gg          , Gs^Fds      , Gg          , Gg          , Wo          , Wo          
Wo          , Wo          , Wo          , Wo          , Wo          , Wo          , Gg          , Gg          , Gg          , Gg          , Gg          , Gg          , Mm          , Hh          , Hh          , Gg          , Gg          , Wo          , Gg          , Gg          , Gg          , Gs^Fds      , Gs^Fds      , Gs^Fds      , Gg          , Wo          , Wo          
Wo          , Wo          , Gg          , Wo          , Gg          , Gg          , Gg          , Gg          , Gg          , Gg          , Gs^Fds      , Mm          , Gs^Fds      , Mm          , Mm          , Gg          , Gg          , Gg          , Gg          , Gg          , Gg          , Gs^Fds      , Gg          , Gs^Fds      , Gg          , Wo          , Wo          
Wo          , Wo          , Wo          , Gg          , Gg          , Gg          , Hh          , Hh          , Gg          , Gg          , Gs^Fds      , Gs^Fds      , Gs^Fds      , Gs^Fds      , Gs^Fds      , Mm          , Gg          , Gg          , Gg          , Gg          , Mm          , Gg          , Mm          , Gg          , Gg          , Wo          , Wo          
Wo          , Wo          , Wo          , Gg          , Gg          , Gg          , Gg          , Gg          , Gg          , Gg          , Gg          , Gs^Fds      , Gs^Fds      , Gs^Fds      , Gs^Fds      , Gs^Fds      , Gg          , Gg          , Gg          , Gg          , Mm          , Mm          , Mm          , Mm          , Mm          , Wo          , Wo          
Wo          , Wo          , Wo          , Gg          , Mm          , Mm          , Mm          , Mm          , Mm          , Gg          , Gg          , Gg          , Gg          , Gs^Fds      , Gg          , Gg          , Gg          , Gg          , Gg          , Gg          , Gg          , Mm          , Mm          , Mm          , Mm          , Wo          , Wo          
Wo          , Wo          , Wo          , Mm          , Mm          , Mm          , Gg          , Mm          , Gg          , Gg          , Gg          , Gg          , Gg          , Gg          , Gg          , Gg          , Gg          , Gg          , Hh          , Hh          , Hh          , Gg          , Gg          , Mm          , Gg          , Wo          , Wo          
Wo          , Wo          , Wo          , Mm          , Mm          , Gg          , Hh          , Gg          , Hh          , Gg          , Gg          , Gg          , Wo          , Wo          , Wo          , Gg          , Wo          , Gg          , Gg          , Gg          , Gg          , Gg          , Gg          , Gg          , Gg          , Wo          , Wo          
Wo          , Wo          , Wo          , Wo          , Gg          , Gg          , Gg          , Hh          , Gg          , Gg          , Gg          , Wo          , Wo          , Wo          , Wo          , Wo          , Dd          , Wo          , Wo^Bw\      , Gg          , Gg          , Gg          , Gg          , Gg          , Gg          , Wo          , Wo          
Wo          , Wo          , Wo          , Wo          , Gg          , Gg          , Gs^Fds      , Gg          , Gg          , Gg          , Gg          , Gg          , Mm          , Wo          , Dd          , Dd          , Dd          , Dd          , Dd          , Wo          , Wo          , Gg          , Gg          , Gg          , Gg          , Wo          , Wo          
Wo          , Wo          , Wo          , Hh          , Gg          , Gg          , Gs^Fds      , Gs^Fds      , Gs^Fds      , Gg          , Gg          , Gg          , Dd          , Dd          , Dd          , Dd          , Dd          , Dd          , Dd          , Dd          , Wo          , Gg          , Gg          , Gg          , Wo          , Wo          , Wo          
Wo          , Wo          , Wo          , Hh          , Wo          , Gg          , Mm          , Gs^Fds      , Mm          , Mm          , Dd          , Dd          , Dd          , Dd          , Dd          , Dd          , Dd          , Dd          , Dd          , Dd          , Dd          , Wo^Bw\      , Wo          , Gg          , Wo          , Wo          , Wo          
Wo          , Wo          , Wo          , Wo          , Wo          , Gg          , Mm          , Mm          , Dd          , Dd          , Dd          , Dd          , Dd          , Dd          , Dd          , Dd          , Dd          , Dd          , Dd          , Dd          , Dd          , Wo          , Wo          , Wo          , Wo          , Wo          , Wo          
Wo          , Wo          , Wo          , Wo          , Wo          , Wo          , Dd          , Dd          , Dd          , Dd          , Dd          , Dd          , Dd          , Dd          , Dd          , Dd          , Dd          , Dd          , Dd          , Dd          , Dd          , Dd          , Dd          , Wo          , Wo          , Wo          , Wo          
Wo          , Wo          , Wo          , Wo          , Wo          , Wo          , Wo          , Dd          , Dd          , Dd          , Dd          , Wo          , Wo          , Dd          , Dd          , Dd          , Dd          , Dd          , Dd          , Dd          , Dd          , Dd          , Dd          , Wo          , Wo          , Wo          , Wo          
Wo          , Wo          , Wo          , Wo          , Wo          , Wo          , Wo          , Dd          , Dd          , Dd          , Wo          , Wo          , Wo          , Wo          , Wo          , Dd          , Wo          , Dd          , Dd          , Dd          , Dd          , Dd          , Dd          , Dd          , Wo          , Wo          , Wo          
Wo          , Wo          , Wo          , Wo          , Wo          , Wo          , Wo          , Wo          , Wo          , Wo          , Wo          , Wo          , Wo          , Wo          , Wo          , Wo          , Wo          , Dd          , Wo          , Dd          , Wo          , Dd          , Wo          , Wo          , Wo          , Wo          , Wo          
Wo          , Wo          , Wo          , Wo          , Wo          , Wo          , Wo          , Wo          , Wo          , Wo          , Wo          , Wo          , Wo          , Wo          , Wo          , Wo          , Wo          , Wo          , Wo          , Wo          , Wo          , Wo          , Wo          , Wo          , Wo          , Wo          , Wo          
