border_size=1
usage=map

Gg          , Gg          , Gg          , Gg          , Gg          
Gg          , Rrc         , Wo          , Gs^Vh       , Gg          
Gg          , Sm          , Gg^Bw\      , Gs^Fds      , Gg          
Gg          , Dd          , Hh          , Gg          , Gg          
Gg          , Mm          , Gg          , Gg          , Gg          
Gg          , Gg          , Gg          , Gg          , Gg          
